41
18
00 00 00 00 00 00 00 00 00 00 00 00 00 00 00 00 00 00 00 00 00 00 00 00 00 00 00 00 00 00 00 00 00 00 00 00 00 00 00 00 00 00
00 00 00 00 00 00 00 00 00 00 00 00 00 00 00 00 00 00 00 00 00 00 00 00 00 00 00 00 00 00 00 00 00 00 00 00 00 00 00 00 00 00
00 00 00 00 00 00 00 00 00 00 00 00 00 00 00 00 00 00 00 00 00 00 00 00 00 00 00 00 00 00 00 00 00 00 00 00 00 00 00 00 00 00
00 00 00 00 00 00 00 00 00 00 00 00 00 00 00 00 00 00 00 00 00 00 00 00 00 00 00 00 00 00 00 00 00 00 00 00 00 00 00 00 00 00
00 23 20 20 20 20 20 20 20 20 22 00 00 00 00 00 00 00 00 00 00 00 00 00 00 00 00 00 00 00 00 00 00 00 00 00 00 00 00 00 00 00  5
00 25 18 18 18 18 18 18 18 18 24 00 00 00 00 00 00 00 00 00 00 00 00 00 00 00 00 00 00 23 20 20 20 20 20 20 20 20 20 20 22 00
00 25 18 18 18 18 18 18 18 18 24 00 00 00 00 00 00 23 20 20 20 20 20 22 00 00 00 00 00 25 18 18 18 18 18 18 18 18 18 18 24 00
00 25 18 18 18 18 18 18 18 18 20 20 20 20 20 20 20 20 18 18 18 18 18 20 20 20 20 20 20 20 18 01 02 02 02 02 02 02 03 18 24 00
00 25 18 18 18 18 18 18 18 18 08 10 11 11 11 11 12 09 18 01 02 03 18 08 10 11 11 11 12 09 18 08 10 11 11 11 11 12 09 18 24 00
00 25 18 18 18 18 18 18 18 18 08 13 14 14 14 14 15 09 18 08 04 09 18 08 13 14 14 14 15 09 18 08 16 18 18 18 18 17 09 18 24 00  10
00 25 18 18 18 18 18 18 18 18 31 20 20 20 20 20 20 32 18 05 06 07 18 31 20 20 20 20 20 32 18 08 16 18 18 18 18 17 09 18 24 00
00 25 18 18 18 18 18 18 18 18 24 00 00 00 00 00 00 25 18 18 18 18 18 24 00 00 00 00 00 25 18 08 13 14 14 14 14 15 09 18 24 00
00 25 18 18 18 01 03 18 18 18 24 00 00 00 00 00 00 29 20 20 20 20 20 30 00 00 00 00 00 25 18 05 06 06 06 06 06 06 07 18 24 00
00 29 20 20 32 08 09 31 20 20 30 00 00 00 00 00 00 00 00 00 00 00 00 00 00 00 00 00 00 25 18 18 18 18 18 18 18 18 18 18 24 00
00 00 00 00 25 08 09 24 00 00 00 00 00 00 00 00 00 00 00 00 00 00 00 00 00 00 00 00 00 29 20 20 20 20 20 20 20 20 20 20 30 00  15
00 00 00 00 25 08 09 24 00 00 00 00 00 00 00 00 00 00 00 00 00 00 00 00 00 00 00 00 00 00 00 00 00 00 00 00 00 00 00 00 00 00
00 00 00 00 25 08 09 24 00 00 00 00 00 00 00 00 00 00 00 00 00 00 00 00 00 00 00 00 00 00 00 00 00 00 00 00 00 00 00 00 00 00
00 00 00 00 25 08 09 24 00 00 00 00 00 00 00 00 00 00 00 00 00 00 00 00 00 00 00 00 00 00 00 00 00 00 00 00 00 00 00 00 00 00
            05             10             15             20             25             30             35             40