43
14
36 15 15 15 15 15 15 15 15 36 15 15 15 15 15 14 15 15 15 15 15 15 22 25 25 25 25 25 23 15 15 15 15 15 15 15 15 15 31 35 35 35 30
15 01 10 10 10 10 10 10 10 10 10 10 10 10 10 10 10 10 10 10 10 02 26 15 15 15 15 14 27 15 15 15 22 25 25 25 23 15 32 18 09 18 33
15 13 16 16 16 16 16 16 16 16 16 16 16 16 16 16 16 16 16 16 16 12 26 15 36 15 15 15 27 15 15 15 26 15 15 15 27 15 32 18 18 18 33
15 03 11 11 11 11 11 11 11 11 11 11 08 16 16 16 16 16 16 16 16 12 26 15 15 15 15 15 27 15 15 15 26 15 15 15 27 15 32 18 18 18 33
31 35 35 35 35 35 35 35 35 35 35 30 13 16 16 16 07 11 08 16 16 12 26 15 15 15 15 15 27 15 15 15 26 15 15 15 27 15 32 18 18 09 33  5
32 18 18 18 18 18 18 18 18 09 18 33 13 16 16 16 12 36 13 16 16 12 26 15 15 14 15 15 27 15 14 15 20 24 19 24 21 15 32 18 18 18 33
32 18 09 18 18 18 18 18 18 18 18 33 13 16 16 16 06 10 05 16 16 12 26 15 15 15 15 15 27 15 15 15 15 01 10 02 15 15 32 18 18 18 33
32 18 18 18 18 18 09 18 18 18 18 33 13 16 16 16 16 16 16 16 16 12 26 15 14 15 15 36 27 15 15 15 15 13 16 12 15 15 32 09 18 18 33
32 18 18 09 18 18 18 18 09 18 18 33 13 07 11 11 11 08 16 16 16 12 26 15 15 15 15 15 27 15 15 14 15 13 16 12 15 15 32 18 18 18 33
28 34 34 34 34 34 34 34 34 34 34 29 13 12 15 14 15 13 16 16 16 12 20 24 24 17 24 24 21 36 15 15 15 13 16 12 15 15 32 18 18 18 33  10
15 01 10 10 10 10 10 10 10 10 10 10 05 06 10 10 10 05 16 16 16 06 10 10 10 10 10 10 10 10 10 10 10 05 16 12 15 15 32 18 18 18 33
15 13 16 16 16 16 16 16 16 16 16 16 16 16 07 11 11 11 11 11 11 11 11 11 11 11 11 11 11 11 11 11 11 11 11 04 15 15 28 34 34 34 29
15 13 16 16 16 16 16 16 16 16 16 16 16 16 12 22 25 25 25 25 25 25 25 25 25 25 25 25 25 23 31 35 35 35 35 35 30 15 15 15 15 14 15
36 03 11 11 11 11 11 11 11 11 11 11 11 11 04 26 15 15 15 15 15 15 15 15 15 15 15 15 15 27 32 18 18 18 09 18 33 15 15 36 15 15 36
            05             10             15             20             25             30             35             40