12
10
01 02 31 35 35 35 35 35 35 30 01 02
13 12 32 18 18 18 18 18 18 33 13 12
13 12 32 18 18 18 18 18 18 33 13 12
13 12 32 18 18 18 18 18 18 33 13 12
13 12 28 34 34 34 34 34 34 29 13 12
13 06 10 10 10 10 10 10 10 10 05 12
13 16 16 16 16 16 16 16 16 16 16 12
13 16 16 16 16 16 16 16 16 16 16 12
03 11 11 11 11 11 11 11 11 11 11 04
15 15 15 15 15 15 15 15 15 15 15 15